1 1 1 1 1 1 1 1 1 0 1 1 1 1 1 1 1 1 1 1
1 1 1 1 7 1 1 1 1 0 1 1 1 1 0 5 0 1 1 1
1 1 1 1 1 1 1 1 1 0 1 0 1 1 1 1 1 1 1 1
1 1 1 1 1 1 1 1 1 0 1 4 1 1 1 1 1 1 1 1
1 1 1 0 4 0 1 1 1 0 1 0 1 1 1 1 1 1 1 1
1 1 1 1 1 1 1 1 1 0 1 1 1 1 1 7 1 1 1 1
1 1 1 1 1 1 1 1 0 2 0 1 1 1 1 1 1 1 1 1
1 1 1 1 1 7 1 1 1 1 1 1 1 1 1 1 1 1 1 1
1 1 1 1 1 1 1 1 0 1 1 1 1 1 1 1 1 7 1 1
1 1 1 1 1 1 1 1 4 1 1 1 1 0 5 0 1 1 1 1
1 1 1 1 1 1 1 1 1 1 1 1 1 1 1 1 1 1 1 1